41
25
1 1 1 1 1 1 1 1 1 1 1 1 1 1 1 1 1 1 1 1 1 1 1 1 1 1 1 1 1 1 1 1 1 1 1 1 1 1 1 1 
18 5 1 4 25 46 1 1 1 1 1 1 1 1 1 1 1 1 1 1 1 1 1 1 1 1 1 1 1 1 1 1 1 1 1 1 1 1 1 1 
1 1 1 1 1 1 1 1 1 1 1 1 1 1 1 1 1 1 1 1 1 1 1 1 1 1 1 1 1 1 1 1 1 1 1 1 1 1 1 1 
1 1 1 1 1 1 1 1 1 1 1 1 1 1 1 1 1 1 1 1 1 1 1 1 1 1 1 1 1 1 1 1 1 1 1 1 1 1 1 1 
1 1 1 1 1 1 1 1 81 81 81 81 1 1 1 1 1 1 1 1 1 1 1 1 1 1 1 1 1 81 81 81 81 1 1 1 1 1 82 1 
1 1 1 1 1 1 1 1 1 81 81 81 81 1 1 1 1 1 1 1 1 1 1 1 1 1 1 1 81 81 81 81 1 1 1 1 1 1 1 1 
1 1 1 1 1 1 1 1 1 1 81 81 81 81 1 1 1 1 1 1 1 1 1 1 1 1 1 81 81 81 81 1 1 1 1 1 1 1 1 1 
1 1 1 1 1 1 1 1 1 1 1 81 81 81 81 1 1 1 1 1 1 1 1 1 1 1 81 81 81 81 1 1 1 1 1 1 1 1 1 1 
1 1 1 1 81 1 1 1 1 1 1 1 81 81 81 81 1 1 1 1 1 1 1 1 1 81 81 81 81 1 1 1 1 1 1 1 81 1 1 1 
1 1 1 1 81 81 1 1 1 1 1 1 1 1 1 1 1 1 1 1 1 1 1 1 1 1 1 1 1 1 1 1 1 1 1 81 81 1 1 1 
1 1 1 1 81 81 81 1 81 1 1 1 1 1 1 1 1 1 1 1 1 1 1 1 1 1 1 1 1 1 1 1 81 1 81 81 81 1 1 1 
1 1 1 1 81 81 81 81 81 1 1 1 1 1 1 1 1 1 1 1 1 1 1 1 1 1 1 1 1 1 1 1 81 81 81 81 81 1 1 1 
1 1 1 1 1 81 81 81 81 1 1 1 1 1 1 1 1 1 1 1 1 1 1 1 1 1 1 1 1 1 1 1 81 81 81 81 1 1 1 1 
1 1 1 1 1 81 81 81 81 1 1 1 1 1 1 1 1 1 1 1 1 1 1 1 1 1 1 1 1 1 1 1 81 81 81 81 1 1 1 1 
1 1 1 1 81 81 81 81 81 1 1 1 1 1 1 1 1 1 1 1 1 1 1 1 1 1 1 1 1 1 1 1 81 81 81 81 81 1 1 1 
1 1 1 1 81 81 81 1 81 1 1 1 1 1 1 1 1 1 1 1 1 1 1 1 1 1 1 1 1 1 1 1 81 1 81 81 81 1 1 1 
1 1 1 1 81 81 1 1 1 1 1 1 1 1 1 1 1 1 1 1 1 1 1 1 1 1 1 1 1 1 1 1 1 1 1 81 81 1 1 1 
1 1 1 1 81 1 1 1 1 1 1 1 81 81 81 81 1 1 1 1 1 1 1 1 1 81 81 81 81 1 1 1 1 1 1 1 81 1 1 1 
1 1 1 1 1 1 1 1 1 1 1 81 81 81 81 1 1 1 1 1 1 1 1 1 1 1 81 81 81 81 1 1 1 1 1 1 1 1 1 1 
1 1 1 1 1 1 1 1 1 1 81 81 81 81 1 1 1 1 1 1 1 1 1 1 1 1 1 81 81 81 81 1 1 1 1 1 1 1 1 1 
1 1 1 1 1 1 1 1 1 81 81 81 81 1 1 1 1 1 1 1 1 1 1 1 1 1 1 1 81 81 81 81 1 1 1 1 1 1 1 1 
1 1 1 1 1 1 1 1 81 81 81 81 1 1 1 1 1 1 1 1 1 1 1 1 1 1 1 1 1 81 81 81 81 1 1 1 1 1 1 1 
1 1 1 1 1 1 1 1 1 1 1 1 1 1 1 1 1 1 1 1 1 1 1 1 1 1 1 1 1 1 1 1 1 1 1 1 1 1 1 1 
1 1 1 1 1 1 1 1 1 1 1 1 1 1 1 1 1 1 1 1 1 1 1 1 1 1 1 1 1 1 1 1 1 1 1 1 1 1 1 1 
1 1 1 1 1 1 1 1 1 1 1 1 1 1 1 1 1 1 1 1 1 1 1 1 1 1 1 1 1 1 1 1 1 1 1 1 1 1 1 1 
